

NO texture/north


SO texture/south

111111111111
10000010011
1000000N001     111
11001101101
10000000001
11111111111111