1111111
1001001
1000001


1101101
1111111111